terrains/dirt/dirt01.png
terrains/dirt/dirt-wall01.png
terrains/dirt/dirt02.png
terrains/dirt/dirt-wall02.png

30 20
0 1  0 1  0 1  0 1  0 1  0 1  0 1  0 1  0 1  0 1
    0 1  0 1  0 1  0 1  0 1  0 1  0 1  0 1  0 1  0 1
    0 1  0 1  0 1  0 1  0 1  1 1  0 1  0 1  0 1  0 1

0 1  0 1  0 1  0 1  0 1  0 1  0 1  0 1  0 1  0 1
    0 1  0 1  0 1  0 1  0 1  1 1  1 1  0 1  0 1  0 1
    0 1  0 1  0 1  0 1  0 1  0 1  0 1  1 1  0 1  0 1

0 1  0 1  0 1  0 1  0 1  0 1  0 1  0 1  0 1  0 1
    0 1  0 1  0 1  0 1  0 1  0 1  1 1  1 1  0 1  0 1
    0 1  0 1  0 2  0 1  0 1  0 1  0 1  0 1  0 1  0 1

0 1  0 1  0 1  0 1  0 1  0 1  0 1  0 1  0 1  0 1
    0 1  0 1  0 1  0 1  0 1  0 1  0 1  0 1  0 1  0 1
    0 2  0 2  1 2  1 2  0 1  0 1  0 1  0 1  1 1  0 1

0 1  0 1  0 1  0 1  0 1  0 1  0 1  0 1  0 1  0 1
    0 1  0 1  0 1  0 1  0 1  0 1  0 1  0 1  0 1  0 1
    0 1  0 1  1 2  0 2  0 1  0 1  0 1  0 1  1 1  0 1

0 1  0 1  0 1  0 1  0 1  0 1  0 1  0 1  0 1  0 1
    0 1  0 1  0 1  0 1  0 1  0 1  0 1  0 1  1 1  0 1
    0 1  0 1  0 1  0 2  0 1  0 1  0 1  0 1  1 1  0 1

0 1  0 1  0 1  0 1  0 1  0 1  0 1  0 1  0 1  0 1
    0 1  0 1  0 1  0 1  0 1  0 1  0 1  0 1  0 1  0 1
    0 1  0 1  0 1  0 1  0 1  0 1  0 1  0 1  1 1  0 1

0 1  0 1  0 1  0 1  0 1  0 1  0 1  0 1  0 1  0 1
    0 1  0 1  0 1  0 1  0 1  0 1  0 1  0 1  0 1  0 1
    0 1  0 1  0 1  0 1  0 1  0 1  0 1  0 1  0 1  0 1

0 1  0 1  0 1  0 1  0 1  0 1  0 1  0 1  0 1  0 1
    0 1  0 1  0 1  0 1  0 1  0 1  0 1  0 1  0 1  0 1
    0 1  0 1  0 1  0 1  0 1  0 1  0 1  0 1  0 1  0 1

0 1  0 1  0 1  0 1  0 1  0 1  0 1  0 1  0 1  0 1
    0 1  0 1  0 1  0 1  0 1  0 1  0 1  0 1  0 1  0 1
    0 1  0 1  0 1  0 1  0 1  0 1  0 1  0 1  0 1  0 1


0 1  0 1  0 1  0 1  0 1  0 1  0 1  0 1  0 1  0 1
    0 1  0 1  0 1  0 1  0 1  0 1  0 1  0 1  0 1  0 1
    0 1  0 1  0 1  0 1  0 1  0 1  0 1  0 1  0 1  0 1

0 1  0 1  0 1  0 1  0 1  0 1  0 1  0 1  0 1  0 1
    0 1  0 1  0 1  0 1  0 1  0 1  0 1  0 1  0 1  0 1
    0 1  0 1  0 1  0 1  0 1  0 1  0 1  0 1  0 1  0 1

0 1  0 1  0 1  0 1  0 1  0 1  0 1  0 1  0 1  0 1
    0 1  0 1  0 1  0 1  0 1  0 1  0 1  0 1  0 1  0 1
    0 1  0 1  0 1  0 1  0 1  0 1  0 1  0 1  0 1  0 1

0 1  0 1  0 1  0 1  0 1  0 1  0 1  0 1  0 1  0 1
    0 1  0 1  0 1  0 1  0 1  0 1  0 1  0 1  0 1  0 1
    0 1  0 1  0 1  0 1  0 1  0 1  0 1  0 1  0 1  0 1

0 1  0 1  0 1  0 1  0 1  0 1  0 1  0 1  0 1  0 1
    0 1  0 1  0 1  0 1  0 1  0 1  0 1  0 1  0 1  0 1
    0 1  0 1  0 1  0 1  0 1  0 1  0 1  0 1  0 1  0 1

0 1  0 1  0 1  0 1  0 1  0 1  1 1  1 1  0 1  0 1
    0 1  0 1  0 1  0 1  0 1  1 1  1 1  0 1  1 1  0 1
    0 1  0 1  0 1  0 1  0 1  1 1  1 3  1 1  1 1  0 1

0 1  0 1  0 1  0 1  0 1  0 1  0 1  1 1  0 1  0 1
    0 1  0 1  0 1  0 1  0 1  1 1  1 1  0 1  1 1  0 1
    0 1  0 1  0 1  0 1  0 1  1 1  1 2  0 1  0 1  0 1

0 1  0 1  0 1  0 1  0 1  0 1  0 1  1 1  1 1  0 1
    0 1  0 1  0 1  0 1  0 1  1 1  1 1  1 1  1 1  0 1
    0 1  0 1  0 1  0 1  0 1  0 1  0 1  0 1  1 1  0 1

0 1  0 1  0 1  0 1  0 1  0 1  0 1  0 1  0 1  0 1
    0 1  0 1  0 1  0 1  0 1  0 1  0 1  0 1  0 1  0 1
    0 1  0 1  0 1  0 1  0 1  0 1  0 1  0 1  0 1  0 1

0 1  0 1  0 1  0 1  0 1  0 1  0 1  0 1  0 1  0 1
    0 1  0 1  0 1  0 1  0 1  0 1  0 1  0 1  0 1  0 1
    0 1  0 1  0 1  0 1  0 1  0 1  0 1  0 1  0 1  0 1
