{
  "width": 20,
  "height": 20,
  "data": [
    [1, 1, 1, 1, 1, 1, 1, 1, 1, 1, 1, 1, 1, 1, 1, 1, 1, 1, 1, 1],
    [1, 0, 0, 0, 0, 0, 0, 0, 0, 0, 0, 0, 0, 0, 0, 0, 0, 0, 0, 1],
    [1, 0, 0, 0, 0, 0, 0, 0, 0, 0, 0, 0, 0, 0, 0, 0, 0, 0, 0, 1],
    [1, 0, 0, 0, 0, 0, 0, 0, 0, 0, 0, 0, 0, 0, 0, 0, 0, 0, 0, 1],
    [1, 0, 0, 0, 0, 0, 0, 0, 0, 0, 0, 0, 0, 0, 0, 0, 0, 0, 0, 1],
    [1, 0, 0, 0, 0, 0, 0, 0, 0, 0, 0, 0, 0, 0, 0, 0, 0, 0, 0, 1],
    [1, 0, 0, 0, 0, 0, 0, 0, 0, 0, 0, 0, 0, 0, 0, 0, 0, 0, 0, 1],
    [1, 0, 0, 0, 0, 0, 0, 0, 0, 0, 0, 0, 0, 0, 0, 0, 0, 0, 0, 1],
    [1, 0, 0, 0, 0, 0, 0, 0, 0, 0, 0, 0, 0, 0, 0, 0, 0, 0, 0, 1],
    [1, 0, 0, 0, 0, 0, 0, 0, 0, 0, 0, 0, 0, 0, 0, 0, 0, 0, 0, 1],
    [1, 0, 0, 0, 0, 0, 0, 1, 1, 0, 0, 1, 1, 0, 0, 0, 0, 0, 0, 1],
    [1, 0, 0, 0, 0, 0, 0, 1, 1, 0, 0, 1, 1, 0, 0, 0, 0, 0, 0, 1],
    [1, 0, 0, 0, 0, 0, 0, 0, 0, 0, 0, 0, 0, 0, 0, 0, 0, 0, 0, 1],
    [1, 0, 1, 0, 1, 0, 1, 0, 1, 0, 1, 0, 1, 0, 1, 0, 1, 0, 1, 1],
    [1, 0, 0, 0, 0, 0, 0, 0, 0, 0, 0, 0, 0, 0, 0, 0, 0, 0, 0, 1],
    [1, 0, 0, 0, 0, 0, 0, 0, 0, 0, 0, 0, 0, 0, 0, 0, 0, 0, 0, 1],
    [1, 0, 0, 0, 0, 0, 0, 0, 0, 0, 0, 0, 0, 0, 0, 0, 0, 0, 0, 1],
    [1, 0, 0, 0, 0, 0, 0, 0, 0, 0, 0, 0, 0, 0, 0, 0, 0, 0, 0, 1],
    [1, 0, 0, 0, 0, 0, 0, 0, 0, 0, 0, 0, 0, 0, 0, 0, 0, 0, 0, 1],
    [1, 1, 1, 1, 1, 1, 1, 1, 1, 1, 1, 1, 1, 1, 1, 1, 1, 1, 1, 1]
  ],
  "terrain": "terrains/dirt.terrain",
  "blueprint_set": "blueprints/mainSet.bpset.json",
  "units": [{
    "type": 2,
    "x": 10,
    "y": 10
  }, {
    "type": 0,
    "x": 1,
    "y": 1
  }, {
    "type": 0,
    "x": 1,
    "y": 18
  }, {
    "type": 0,
    "x": 18,
    "y": 1
  }, {
    "type": 0,
    "x": 18,
    "y": 18
  }, {
    "type": 3,
    "x": 2,
    "y": 1
  }, {
    "type": 3,
    "x": 3,
    "y": 1
  }, {
    "type": 3,
    "x": 4,
    "y": 1
  }, {
    "type": 3,
    "x": 5,
    "y": 1
  }, {
    "type": 3,
    "x": 6,
    "y": 1
  }, {
    "type": 3,
    "x": 7,
    "y": 1
  }, {
    "type": 3,
    "x": 8,
    "y": 1
  }, {
    "type": 3,
    "x": 9,
    "y": 1
  }, {
    "type": 3,
    "x": 10,
    "y": 1
  }, {
    "type": 3,
    "x": 11,
    "y": 1
  }, {
    "type": 3,
    "x": 12,
    "y": 1
  }, {
    "type": 3,
    "x": 13,
    "y": 1
  }, {
    "type": 3,
    "x": 14,
    "y": 1
  }, {
    "type": 3,
    "x": 15,
    "y": 1
  }, {
    "type": 3,
    "x": 16,
    "y": 1
  }, {
    "type": 3,
    "x": 17,
    "y": 1
  }]
}